SO ./meupiru

1111111111111111
1001111111110001
101         10001
101   1111  1001
101  11 101 10001111
1N1  11 101 10001111
 1      101  111 
   1111101
  101 1101
  111   1 