NO ./assets/sprites/teste
SO ./assets/sprites/teste
WE ./assets/sprites/teste
EA ./assets/sprites/teste
F ./assets/sprites/teste
C ./assets/sprites/teste

1111111111111111111
1010000000000100001
1010001100000000001
1010000010000111101111111
1000000011111100001111111
1N00000000000000001111111
1111111111111111111