NO ./assets/sprites/north.xpm
SO ./assets/sprites/south.xpm
WE ./assets/sprites/west.xpm
EA ./assets/sprites/east.xpm
F ./assets/sprites/teste
C ./assets/sprites/teste

1111111111111111111
1010000000000100001
1010001100000000001
10100N0010000111101111111
1000000011111100001111111
1N00000000000000001111111
1111111111111111111