NO ./assets/sprites/teste
SO ./assets/sprites/teste
WE ./assets/sprites/teste
EA ./assets/sprites/teste
F ./assets/sprites/teste
C ./assets/sprites/teste

1111111111111111111
1010000000000100001
1010001100N00000001
1010000010000111101
1000000011111100001
1000000000000000001
1111111111111111111