NO ./assets/sprites/north.xpm
SO ./assets/sprites/south.xpm
WE ./assets/sprites/west.xpm
EA ./assets/sprites/east.xpm
F ./assets/sprites/teste
C ./assets/sprites/teste

1111111111111111111
1010000000100100001
1010001101000000001
1010000010N00111101
1000000011111100001
1000000000000000001
1111111111111111111